2m1m0g0g0g0g0g0g0g0g
1m1m0g0g0g0g0g0g0g0g
1m0m0m0g0g0g0g0g0g0g
1g0g0m0m0m0m0g0g0g0g
0g0g0g0g0g0m0g0g0g0g
0g0g0g0g0g0g0m0g0g0g
0g0g0g0g0g0g0m0g0g0g
0g0g0g0g0g0g0g0m0m0g
0g0g0g0g0g0g0g0g0m0g
0g0g0g0g0g0g0g0g0m0g