2m1m0g0g0g0g0g0g0g0g
1m1m0g0g0g0g0g0g0g0g
1m0m0m0g0g0g0g0g0g0g
1g0g0m0m0m0m0g0g0g0g
0g0g0g0g0g0m0g0g0g0g
0g0g0g0g0g0g0m0g0g0g
0g0g0g0g0g0g0m0g0g0g
1g0g0g0g0g0g0g0m0m0g
1g1g0g0g0g0g0g0g0m0g
1g1g1g1g1g0g0g0g0m0g
=0 5 0 Mirness-1A-reset.stl
=9 2 3 BT-BushWacker_IIC-reset.stl
=9 6 3 BT-BushWacker_IIC-reset.stl